
umbrella = paraguas
somebody = alguien
already = ya
something = algo
about = acerca de
key = llave
begin = comience
places = lugares
carefull = con cuidado
got = tiene
havent't = no tengo
statements = declaraciones
hair = pelo
blond = rubia
about = sobre
issues = cuestiones
magazines = revistas
garden = jardin
choose = elije
near = cerca de
both = ambos
but = pero
travel = viaje
together = juntos
journey = viaje
have = tiene
whatch = ver
week = semana
late = tardio
enough = suficiente
talk = hable
how = como
wear = desgaste
whant = quiero
learn = aprender
shoner = ducha
each = cada
sentence = frase
I = yo
walk = camino
fat = r√°pido